111111111111111111111111111111111111111
1E0000000000000C00000C00000000000111111
101001010010000010100100000001001111111
101001001010101000100100000001010111111
1P0000000C00C0000000000000000000C111111
111111111111111111111111111111111111111